{"levelData":[[00,00,00,00,00,00,00,00]
 			  [00,00,00,00,00,00,00,00]
			  [00,00,00,00,00,00,00,00]
		 	  [00,00,00,00,00,00,00,00]
		 	  [00,00,00,03,03,04,00,00]
		 	  [01,01,02,02,02,02,01,01]]}