{"Data":[[1,2,1,1,1,1,1,1,1,2,1,1,1,1,1,2,1,1,1,1,1,1,1,1,1,1,1,1,1,1,1,1,1,1,1,1,1,2,1,1,1,1,1,1,1],
 		 [0,0,23,14,3,5,5,0,0,0,3,5,0,0,0,0,3,3,4,3,4,4,3,3,3,5,3,3,4,5,4,5,3,3,5,5,5,0,3,4,4,5,0,0,0],
		 [0,0,0,0,23,5,0,0,0,0,0,0,0,0,0,0,0,0,0,3,4,4,3,3,3,5,3,3,4,5,4,5,3,3,5,5,0,0,0,0,4,5,0,0,0],
		 [0,0,0,0,0,0,0,0,0,0,0,0,0,0,0,0,0,0,0,0,0,4,3,3,3,5,3,3,4,5,4,5,3,3,5,0,0,0,0,0,0,5,0,0,0],
		 [0,0,0,0,0,0,0,0,0,0,0,0,0,0,0,0,0,0,0,0,0,0,3,3,3,5,0,0,0,5,0,5,0,0,0,0,0,0,0,0,0,0,0,0,0],
		 [0,0,0,0,0,0,0,0,0,0,0,0,0,0,0,0,0,0,0,0,0,0,0,0,0,0,0,0,0,0,0,0,0,0,0,0,0,0,0,0,0,0,0,0,0]]}