{"Data":[[1,2,1,1,1,1,1,1,1,2,1,1,1,1,11,2,1,1,1,1,1,1,1,1,1,1,1,1,1,1,1,1,1,1,1,1,1,2,1,1,1,1,1,21,1,22,1,1,1,1,1,1,1,1,1,1,1,1,1,1],
 		 [0,0,3,4,3,5,5,0,0,0,3,15,0,0,0,0,3,3,4,3,4,4,3,3,3,5,3,3,4,5,4,5,3,3,5,5,5,0,3,4,4,5,0,0,0,0,3,3,4,3,3,3,3,5,3,5,0,0,0,0],
		 [0,0,0,0,3,5,0,0,0,0,0,0,0,0,0,0,0,0,0,3,24,4,3,3,3,5,3,3,4,5,4,5,3,3,5,5,0,0,0,0,4,5,0,0,0,0,0,0,0,3,23,3,3,15,0,0,0,0,0,0],
		 [0,0,0,0,0,0,0,0,0,0,0,0,0,0,0,0,0,0,0,0,0,4,3,3,3,5,3,3,14,5,4,5,3,13,5,0,0,0,0,0,0,5,0,0,0,0,0,0,0,0,0,0,0,0,0,0,0,0,0,0],
		 [0,0,0,0,0,0,0,0,0,0,0,0,0,0,0,0,0,0,0,0,0,0,3,3,13,5,0,0,0,5,0,5,0,0,0,0,0,0,0,0,0,0,0,0,0,0,0,0,0,0,0,0,0,0,0,0,0,0,0,0],
		 [0,0,0,0,0,0,0,0,0,0,0,0,0,0,0,0,0,0,0,0,0,0,0,0,0,0,0,0,0,0,0,0,0,0,0,0,0,0,0,0,0,0,0,0,0,0,0,0,0,0,0,0,0,0,0,0,0,0,0,0]]}